1,0,0,0,0,0,0,0,0,0,0
0,1,0,1,0,1,0,1,0,1,0
0,0,0,0,0,0,0,0,0,0,0
0,1,0,1,0,1,0,1,0,1,0
0,0,0,0,0,0,0,0,0,0,0
0,1,0,1,0,1,0,1,0,1,0
0,0,0,0,0,0,0,0,0,0,0
0,1,0,1,0,1,34,1,0,1,0
0,0,0,0,0,0,0,0,0,0,0
0,1,0,1,0,1,0,1,0,1,0
0,0,0,0,0,0,0,0,0,0,0
0,1,0,1,0,1,0,1,0,1,0
0,0,0,0,0,0,0,34,0,0,0
0,1,0,1,0,1,0,1,0,1,0
0,0,0,0,0,0,0,0,0,0,0