34|31,34|31,34|31,34|31,34|31,34|31,34|31,34|31,34|31,34|31,34|31
34,34|70,34,34,34|66,34,34,34,34,34,34|68
31,31,31,31,31,31,31,31,31,31,31
0,0,0,0,0,0,0,0,0,0,0
0,1,0,1,0,15,0,1,0,1,0
0,15,0,0,0,0,0,0,17,0,0
0,1,0,1,0,1,0,1,0,15,15
0,0,0,0,0,0,0,0,0,0,0
14,1,0,1,0,15,3,1,0,1,0
0,0,0,0,0,0,0,0,0,0,0
0,1,0,1|68,0,1,15,1,0,1,0
0,0,0,0,0,34|34|34|34,34,0,0,0,0
0,1,15,1,0,1,0,1,0,1,0
0,0,0,0,0,0,0,3,15,0,0
0,1,1|150|130|142,1,0,1,0,1,0,1,0